----------
---OOOOOOO-
---O-----O-
SOOOOOO--O-
---O--O--O-
---O--O--O-
---OOOO--O-
---------F-